R 950 600
NO textures32/brick.xpm
SO textures32/metal.xpm
WE textures32/stone.xpm
EA textures32/wood.xpm

S textures32/sprites/pillar.xpm
C 130,76,25
F 20,38,55

1111111111111111111111111111111111111111111111111
1011000000000000000000010000000000000000000000001
1001000000000000000000010000000000000000000000001
1000000000000000000000010000000000000000000000001
100S000000000000000000001000000000000000000000001
1000000000000000000000000100000000000000000000001
1110000000000000000000000010000000000000000000001
1000000000000100000000000000000000000000000000001
1100000000000100000000000000000000000000000000001
1111111111111111111111111111111111111111111111111

